WWWWWWWWWWWWWWW
WFFFFFFGFFFFFFW
WFFFFFFFFFFFFFW
WFFFFFFFFFFFFFW
WFFFFFFFFFFFFFW
WFFFFFFFFFFFFFW
WFFFFFFFFFFFFFW
WFFFFFFFFFFFFFW
WFFFFFFFFFFFFFW
WFFFFFFFFFFFFFW
WFFFFFFFFFFFFFW
WFFFFFFFFFFFFFW
WFFFFFFFFFFFFFW
WFFFFFFPFFFFFFW
WWWWWWWWWWWWWWW
