 WWWWWWWWWWWWW     
WFFFFFFPFFFFFFW
WFFFFFFFFFFFFFW
WBFFFFFFFFFFFFW
WFFFFFFFFFFFFFW
WFFFFFFFFFFFFFW
WFFFFFFFFFFFFFW
WFFFFFFFFFFFFFW
WFFFFFFFFFFFFFW
WFFFFFFFFFFFFFW
WFFFFFFFFFFFFFW
WFFFFFFFFFFFFFW
WFFFFFFFFFFFBFW
WBFFFFFFFFFFFFW
 WWWWWWWWWWWWW
