      W
FFFFFFPFFFFFFW
FFFFFFFFFFFFFW
BFFFFFFFFFFFFW
FFFFFFFFFFFFFW
FFFFFFFFFFFFFW
FFFFFFFFFFFFFW
FFFFFFFFFFFFFW
FFFFFFFFFFFFFW
FFFFFFFFFFFFFW
FFFFFFFFFFFFFW
FFFFFFFFFFFFFW
FFFFFFFFFFFBFW
BFFFFFFFFFFFFW

